R   1200 1000

NO  block/diamond_block.XPM
SO  block/andesite.XPM
WE  block/bedrock.XPM
EA  block/black_glazed_terracotta.XPM
S   block/cornflower.XPM

F   220,100,0
C   225,30,0

1111111111111111111111111111111111111111111111111111111111111111111111111111111111111111111111111111111111111111111111111111
1000010001111111111111111111111100111111111111111111111111111111111111111111111111111111111111111111111111111111111111111111
1001000001111111111111111111111100111111111111111111111111111111111111111111111111111111111111111111111111111111111111111111
1111111001111111111111111111111100111111100000000111111111111111111111111111111111111111111111111111111111111111111111111111
1000000001111111111111111111111100111111100000000111111111111111111111111111111111111111111111111111111111111111111111111111
1000000000000000000000111111111100111111111111100111111111111111111111111111111111111111111111111111111111111111111111111111
1001111001000000000000100000000000000000000001100111111111111111111111111111111111111111111111111111111111111111111111111111
1001001001111001111100100000000000000000000001100111111111111111111111111111111111111111111111111111111111111111111111111111
1001000000000000000000100111111100111111111001100111111111111111111111111111111111111111111111111111111111111111111111111111
1001000000000000000000100100000000111111100001100111111111111111111111111111111111111111111111111111111111111111111111111111
1001111111111111111111100111111111111111111001100111111111111111111111111111111111111111111111111111111111111111111111111111
1000000000000010000000000000000000000001111000000000000011111111111111111111111111111111111111111111111111111111111111111111
1000000000000000001000000000000000000001111000000000000011111111111111111111111111111111111111111111111111111111111111111111
1111111100111111111111100111111111001001111111111111110011111111111111111111111111111111111111111111111111111111111111111111
1000011100100000011000100100000100001001111111111111110011111111111111111111111111111111111111111111111111111111111111111111
1000000000000010011000100100100000001000000000000011111111111111111111111111111111111111111111111111111111111111111111111111
1000000000000011111000100111111111111000000000000011111111111111111111111111111111111111111111111111111111111111111111111111
1011001111011010000000100000000000001001111111110011111111111111111111111111111111111111111111111111111111111111111111111111
1001000001000010011000100000000000001001000000010011000000111111111111111111111111111111111111111111111111111111111111111111
1010101011000000000111100111111111001001000000010011000000111111111111111111111111111111111111111111111111111111111111111111
1001000101111100100010000100000000001001111110010011001111111111111111111110001111111111111111111111111111111111111111111111
1000010000100100100000100100000000001001000010010011001111111111100000000000001111111111111111111111111111111111111111111111
1001101110000111100110100111111111111001111110010000000000000000100000000000001111111111111111111111111111111111111111111111
1001000101000100000000100000000000000000000000010000000000000000111111001111001111111111111111111111111111111111111111111111
1000010001000100000000100000000000000000000000010011111111111100000000001000000000111111111111111111111111111111111111111111
1111111111111111111111111111111111111001111110010000011100000100000000001000000000111111111111111111111111111111111111111111
1000000000000000000000000000001000001001000010011111111100000111111111001111111111111111111111111111111111111111111111111111
1000000000000000000000000000001001001001000010000000000000000000000000000000000000111111111111111111111111111111111111111111
1000000000000000000000000000001001001001000010000000000000000000000000000000000000111111111111111111111111111111111111111111
1000000000000000000000000111111001111001000011111111111100000111110011111111111111111111111111111111111111111111111111111111
10000000000W0000000000000000000000000001000000000000000100000100010000000000000000111111111111111111111111111111111111111111
1000000000000000000000000000000000000001000000000000000111111100010000000000000000111111111111111111111111111111111111111111
1000000000000000000000000111111111111111000000000000000000000000010011111111111111111111111111111111111111111111111111111111
1000000000000000000000000000000000000000000000000000000000000000010000000001111111111111111111111111111111111111111111111111
1000000000000000000000000000000000000000000000000000000000000000010000000001111111111111111111111111111111111111111111111111
1111111111111111111111111111111111111111111111111111111111111110010000000001111111111111111111111111111111111111111111111111
1111111111111111111111111111111111111111111111111100000011111110011111111001111111111111111111111111111111111111111111111111
1111111111111111111111111111111111111111111111111100000011111110000000001001111111111111111111111111111111111111111111111111
1111111111111111111111111111111111111111111111111111110011111110000000001001111111111111111111111111111111111111111111111111
1111111111111111111111111111111111111111111111111111110000000111111111111001111111111111111111111111111111111111111111111111
1111111111111111111111111111111111111111111111111111110000000111100000000000000000111111111111111111111111111111111111111111
1111111111111111111111111111111111111111111111111111111111100111100000000000000000111111111111111111111111111111111111111111
1111111111111111111111111111111111111111111111111111111111100111100111111001111111111111111111111111111111111111111111111111
1111111111111111111111111111111111111111111111111111111110000000000111111111111111111111111111111111111111111111111111111111
1111111111111111111111111111111111111111111111111111111110000000000111111111111111111111111111111111111111111111111111111111
1111111111111111111111111111111111111111111111111111111111100111111111111111111111111111111111111111111111111111111111111111
1111111111111111111111111111111111111111111111111111111111100111111111111111111111111111111111111111111111111111111111111111
1111111111111111111111111111111111111111111111111111111111111111111111111111111111111111111111111111111111111111111111111111
1111111111111111111111111111111111111111111111111111111111111111111111111111111111111111111111111111111111111111111111111111
1111111111111111111111111111111111111111111111111111111111111111111111111111111111111111111111111111111111111111111111111111
1111111111111111111111111111111111111111111111111111111111111111111111111111111111111111111111111111111111111111111111111111
1111111111111111111111111111111111111111111111111111111111111111111111111111111111111111111111111111111111111111111111111111
1111111111111111111111111111111111111111111111111111111111111111111111111111111111111111111111111111111111111111111111111111
1111111111111111111111111111111111111111111111111111111111111111111111111111111111111111111111111111111111111111111111111111
1111111111111111111111111111111111111111111111111111111111111111111111111111111111111111111111111111111111111111111111111111
1111111111111111111111111111111111111111111111111111111111111111111111111111111111111111111111111111111111111111111111111111
1111111111111111111111111111111111111111111111111111111111111111111111111111111111111111111111111111111111111111111111111111
1111111111111111111111111111111111111111111111111111111111111111111111111111111111111111111111111111111111111111111111111111
1111111111111111111111111111111111111111111111111111111111111111111111111111111111111111111111111111111111111111110001111111
1111111111111111111111111111111111111111111111111111111111111111111111111111111111111111111111111111111111110001000000010001
1111111111111111111111111111111111111111111111111111111111111111111111111111111111111111111111111111111111111000000000000011
1111111111111111111111111111111111111111111111111111111111111111111111111111111111111111111111111111111111110000000000000001
1111111111111111111111111111111111111111111111111111111111111111111111111111111111111111111111111111111111111000000000000011
1111111111111111111111111111111111111111111111111111111111111111111111111111111111111111111111111111111111110001000300010001
1111111111111111111111111111111111111111111111111111111111111111111111111111111111111111111111111111111111111111111111111111
