11111111111111111111111111111
10000000001100000000000000001 
10010000000000000000000010001
10000000001100000111011110001 
11110111111111011101010010001 
10002000000000001100000010001 
11000000110101011111011110N01 
11111111111111111111111111111
