R   1200 1000

NO  block/brain_coral_block.XPM
SO  block/diamond_block.XPM
WE  block/bedrock.XPM
EA  block/black_glazed_terracotta.XPM
S   block/cornflower.XPM

F   220,100,0
C   225,30,0

1111111111111
1001011100001
1000000000001
1000000000001
1000000000001
1000000000001
111O111111111
1000000000001
1000000000001
1000000000001
1000000000001
1111111110111
1000000000001
1000000000001
1000000000001
1000000000001
1110111111111
1000000000001
1000000000001
1000000000001
1000000000001
1111111110111
1000000000001
1000000000001
1000000000001
1000000000001
1011111111111
1000000000001
1000000000001
1000000000001
1000000000001
1111011111111
1000000000001
1000000000001
1000000000001
1000000000001
1010110110111
1000000000001
1000000000001
1000000000001
1000000000001
1001011010011
1000000000001
1000000000001
1000000000001
1000000000001
1100010010111
1000000000001
1000000000001
1000000000001
1000000000001
1001011001011
1000000000001
1000000000001
1000000000001
1000000000001
1010010010001
1000000000001
1000000000001
1000000000001
1000000000001
1001011100001
1000000000001
1000000000001
1000000000001
1000000000001
1010010110111
1000000000001
1000000000001
1000000000001
1000000000001
1001000010011
1000000000001
1000000000001
1000000000001
1000000000001
1100010010111
1000000000001
1000000000001
1000000000001
1000000000001
1001011001011
1000000000001
1000000000001
1000000000001
1000000000001
1010010010001
1000000000001
1000000000001
1000000000001
1000000000001
1001011100001
1000000000001
1000000000001
1000000000001
1000000000001
1010010110111
1000000000001
1000000000001
1000000000001
1000000000001
1001010010011
1000000000001
1000000000001
1000000000001
1000000000001
1100010010111
1000000000001
1000000000001
1000000000001
1000000000001
1001011001011
1000000000001
1000000000001
1000000000001
1000000000001
1010010010001
1000000000001
1000000000001
1000000000001
1000000000001
1001011100001
1000000000001
1000000000001
1000000000001
1000000000001
1010010110111
1000000000001
1000000000001
1000000000001
1000000000001
1001000010011
1000000000001
1000000000001
1000000000001
1000000000001
1100110010111
1000000000001
1000000000001
1000000000001
1000000000001
1001011001011
1000000000001
1000000000001
1000000000001
1000000000001
1010010010001
1000000000001
1000000000001
1000000000001
1000000000001
1000000000001
1000000000001
100000N000001
1111111111111
